111111111111111111111111
10000000000000C000000001
10000000000000P000000001
1000000000C00000000E0001
111111111111111111111111
