111111111111111111111111
100000000000000000000001
100000000C0000P011111111
1000000C0000000C000E0001
111111111111111111111111
111111111111111111111111
100000000000000000000001
100000000C00000011111111
1000000C0000000C000E0001
111111111111111111111111
111111111111111111111111
100000000000000000000001
100000000C0000P011111111
1000000C0000000C000E0001
111111111110000111111111
111111110000111111111111
100000000000000000000001
100000000C00000011111111
1000000C0000000C000E0001
111111111111100111111111
111111111111100111111111
100000000000000000000001
100000000C0000C011111111
1000000C0000000C000E0001
111111100111111111111111
1111111CC111111111111111
100000000000000P00000001
100000000C00000011111111
100E000C0000000C000E0001
111111111110000001111111
111111111000111111111111
100000000000000P00000001
100000000C0000C011111111
1000000C0000000C000E0001
111111111111001111111111
111111111111001111111111
100000000000000000000001
10000E000C000P0011111111
1000000C0000000C000E0001
111111111111111111111111