111111111111111111111111
10000E000000000000000001
100