111111111111111111111111
100E000000000000C000E001
100000111011100011111111
1000000C00000P0C00000001
111111111111111111111111
