111111111111111111111111
1000000000000P0000000001
100000000C0000P011111111
1000000C0000000C000E0001
111111111111111111111111