111111111111111111111111
100E000000000000C000E001
100000111011111111111111
1000000C0000000C000P0001
111111111111111111111111
